{
  "playerStart" : [6.5, 1.5],
  "wallsA" :[
    0,0,0,0,0,1,2,2,2,2,1,0,0,0,0,0,0,0,0,0,
    0,0,0,0,0,2,0,0,0,0,2,0,0,0,0,0,0,0,0,0,
    1,3,3,1,1,2,0,1,1,0,2,1,1,1,1,1,1,1,1,0,
    3,8,0,3,1,2,0,1,1,10,2,1,1,1,1,0,0,12,1,0,
    3,0,0,3,1,2,0,0,0,2,1,1,1,3,1,0,0,0,1,0,
    3,0,0,3,1,1,2,2,2,1,1,1,3,0,0,1,1,1,1,0,
    3,0,0,2,2,1,1,0,0,1,1,2,3,0,0,3,1,1,1,0,
    1,3,2,0,0,22,0,0,0,0,21,0,0,3,3,1,1,1,1,0,
    1,1,2,0,0,1,0,0,9,0,1,0,0,2,1,1,1,1,1,0,
    1,1,1,2,2,1,1,1,20,1,2,2,2,1,1,1,1,1,1,0,
    0,0,0,0,0,0,1,0,0,1,0,0,0,0,0,0,0,0,0,0,
    0,0,0,0,0,0,2,2,2,2,0,0,0,0,0,0,0,0,0,0,
    0,0,0,0,0,0,2,0,0,2,0,0,0,0,0,0,0,0,0,0,
    0,0,0,0,0,0,2,0,0,2,0,0,0,0,0,0,0,0,0,0,
    0,0,0,0,0,0,2,0,0,2,0,0,0,0,0,0,0,0,0,0,
    0,0,0,0,0,0,3,3,3,3,0,0,0,0,0,0,0,0,0,0,
    0,0,0,0,0,0,3,0,0,3,0,0,0,0,0,0,0,0,0,0,
    0,0,0,0,0,0,3,0,11,3,0,0,0,0,0,0,0,0,0,0,
    0,0,0,0,0,0,3,3,3,3,0,0,0,0,0,0,0,0,0,0,
    0,0,0,0,0,0,0,0,0,0,0,0,0,0,0,0,0,0,0,0
    ],
  "wallsB" : [
    0,0,0,0,0,1,1,1,1,1,1,0,0,0,0,0,0,0,0,0,
    0,0,0,0,0,1,1,1,1,1,1,0,0,0,0,0,0,0,0,0,
    1,1,1,1,1,1,1,1,1,1,1,0,0,0,0,0,0,0,0,0,
    1,1,1,1,1,1,1,2,2,1,1,1,1,1,3,3,1,1,1,0,
    1,1,1,1,1,1,2,0,0,2,1,1,1,3,0,0,3,1,1,0,
    1,1,3,3,2,1,2,0,0,2,1,1,1,3,0,0,3,1,1,0,
    1,3,0,0,0,2,2,0,0,2,1,1,0,0,3,3,1,1,1,0,
    1,1,3,0,0,2,1,2,2,1,1,2,0,0,1,1,1,1,1,0,
    1,1,2,0,0,2,1,1,1,1,1,1,2,1,1,1,1,1,1,0,
    1,1,1,2,2,1,1,3,3,1,1,1,1,1,1,1,1,1,1,0,
    0,0,0,0,0,0,3,0,0,3,0,0,0,0,0,0,0,0,0,0,
    0,0,0,0,0,0,3,0,0,3,0,0,0,0,0,0,0,0,0,0,
    0,0,0,0,0,0,3,0,0,3,0,0,0,0,0,0,0,0,0,0,
    0,0,0,0,0,0,1,1,1,1,0,0,0,0,0,0,0,0,0,0,
    0,0,0,0,0,0,1,0,0,1,0,0,0,0,0,0,0,0,0,0,
    0,0,0,0,0,0,1,0,0,1,0,0,0,0,0,0,0,0,0,0,
    0,0,0,0,0,0,1,0,0,1,0,0,0,0,0,0,0,0,0,0,
    0,0,0,0,0,0,1,1,1,1,0,0,0,0,0,0,0,0,0,0,
    0,0,0,0,0,0,1,1,1,1,0,0,0,0,0,0,0,0,0,0,
    0,0,0,0,0,0,0,0,0,0,0,0,0,0,0,0,0,0,0,0

  ],
  "ColorsA" :[
    0,0,1,
    0.5,0,1,
    0,0.5,1
  ],
  "ColorsB" :[
    1,0.5,0,
    1,0,0,
    1,1,0
  ]

}