{
  "playerStart" : [6.5, 1.5],
  "wallsA" :[
    1,1,1,1,2,2,3,3,3,3,3,3,3,3,1,0,0,0,0,0,
    1,0,0,0,0,2,3,0,0,0,0,0,0,8,3,0,0,0,0,0,
    1,0,0,0,0,2,3,0,0,0,0,0,0,0,3,0,0,0,0,0,
    1,20,1,1,2,2,2,3,3,3,3,3,3,3,1,0,0,0,0,0,
    1,83,0,1,2,0,0,2,0,0,0,0,0,0,0,0,0,0,0,0,
    1,0,10,1,2,0,0,2,0,0,0,0,0,0,0,0,0,0,0,0,
    1,0,0,1,2,0,0,2,0,0,0,0,0,0,0,0,0,0,0,0,
    1,0,9,1,2,0,11,2,0,0,0,0,0,0,0,0,0,0,0,0,
    1,1,1,1,2,2,2,2,0,0,0,0,0,0,0,0,0,0,0,0,
    1,1,1,1,1,1,1,1,0,0,0,0,0,0,0,0,0,0,0,0,
    0,0,0,0,0,0,0,0,0,0,0,0,0,0,0,0,0,0,0,0,
    0,0,0,0,0,0,0,0,0,0,0,0,0,0,0,0,0,0,0,0,
    0,0,0,0,0,0,0,0,0,0,0,0,0,0,0,0,0,0,0,0,
    0,0,0,0,0,0,0,0,0,0,0,0,0,0,0,0,0,0,0,0,
    0,0,0,0,0,0,0,0,0,0,0,0,0,0,0,0,0,0,0,0,
    0,0,0,0,0,0,0,0,0,0,0,0,0,0,0,0,0,0,0,0,
    0,0,0,0,0,0,0,0,0,0,0,0,0,0,0,0,0,0,0,0,
    0,0,0,0,0,0,0,0,0,0,0,0,0,0,0,0,0,0,0,0,
    0,0,0,0,0,0,0,0,0,0,0,0,0,0,0,0,0,0,0,0,
    0,0,0,0,0,0,0,0,0,0,0,0,0,0,0,0,0,0,0,0
    ],
  "wallsB" : [
    1,1,1,1,1,1,1,1,1,1,1,1,1,1,1,0,0,0,0,0,
    1,1,2,0,0,0,0,1,0,2,1,1,1,1,1,0,0,0,0,0,
    1,1,2,0,0,0,0,21,0,2,1,1,1,1,1,0,0,0,0,0,
    1,1,1,3,3,0,0,3,3,1,1,1,1,1,1,0,0,0,0,0,
    1,1,1,1,2,0,0,2,1,1,1,1,1,1,1,0,0,0,0,0,
    1,1,1,1,1,2,2,1,0,0,0,0,0,0,0,0,0,0,0,0,
    1,1,1,1,1,1,1,1,0,0,0,0,0,0,0,0,0,0,0,0,
    1,1,1,1,1,1,1,1,0,0,0,0,0,0,0,0,0,0,0,0,
    1,1,1,1,1,1,1,1,0,0,0,0,0,0,0,0,0,0,0,0,
    1,1,1,1,1,1,1,1,0,0,0,0,0,0,0,0,0,0,0,0,
    1,1,1,1,1,1,1,1,0,0,0,0,0,0,0,0,0,0,0,0,
    0,0,0,0,0,0,0,0,0,0,0,0,0,0,0,0,0,0,0,0,
    0,0,0,0,0,0,0,0,0,0,0,0,0,0,0,0,0,0,0,0,
    0,0,0,0,0,0,0,0,0,0,0,0,0,0,0,0,0,0,0,0,
    0,0,0,0,0,0,0,0,0,0,0,0,0,0,0,0,0,0,0,0,
    0,0,0,0,0,0,0,0,0,0,0,0,0,0,0,0,0,0,0,0,
    0,0,0,0,0,0,0,0,0,0,0,0,0,0,0,0,0,0,0,0,
    0,0,0,0,0,0,0,0,0,0,0,0,0,0,0,0,0,0,0,0,
    0,0,0,0,0,0,0,0,0,0,0,0,0,0,0,0,0,0,0,0,
    0,0,0,0,0,0,0,0,0,0,0,0,0,0,0,0,0,0,0,0
  ],
  "ColorsA" :[
    0,1,0,
    0.5,1,0,
    0,1,0.5
  ],
  "ColorsB" :[
    1,0,0,
    1,0.5,0,
    1,0,0.5
  ]

}