{
  "playerStart" : [6.5, 1.5],
  "wallsA" :[
    0,0,0,0,1,1,3,1,3,2,2,2,2,1,1,1,1,0,0,0,
    0,0,0,0,3,0,0,0,3,0,0,0,2,1,1,1,1,0,0,0,
    0,0,0,0,1,0,0,0,50,0,0,0,2,1,1,1,1,0,0,0,
    0,0,0,0,3,0,0,0,1,0,0,0,2,1,1,1,1,0,0,0,
    2,2,2,2,3,3,40,3,2,2,2,2,3,3,3,3,2,0,0,0,
    2,0,0,0,3,0,0,0,2,2,2,2,2,0,0,0,0,0,0,0,
    2,9,0,0,0,0,0,0,1,2,2,2,2,0,0,0,0,0,0,0,
    2,0,0,0,3,0,0,0,2,2,2,2,2,0,0,0,0,0,0,0,
    1,2,2,2,3,3,40,3,3,3,3,3,2,0,0,0,0,0,0,0,
    0,0,0,0,1,0,0,0,3,0,0,0,3,0,0,0,0,0,0,0,
    0,0,0,0,1,0,0,0,40,0,0,0,3,0,0,0,0,0,0,0,
    0,0,0,0,1,0,0,0,3,0,0,0,3,0,0,0,0,0,0,0,
    0,0,0,0,3,1,1,1,2,3,3,3,3,0,0,0,0,0,0,0,
    0,0,0,0,0,0,0,0,0,0,0,0,0,0,0,0,0,0,0,0,
    0,0,0,0,0,0,0,0,0,0,0,0,0,0,0,0,0,0,0,0,
    0,0,0,0,0,0,0,0,0,0,0,0,0,0,0,0,0,0,0,0,
    0,0,0,0,0,0,0,0,0,0,0,0,0,0,0,0,0,0,0,0,
    0,0,0,0,0,0,0,0,0,0,0,0,0,0,0,0,0,0,0,0,
    0,0,0,0,0,0,0,0,0,0,0,0,0,0,0,0,0,0,0,0,
    0,0,0,0,0,0,0,0,0,0,0,0,0,0,0,0,0,0,0,0
    ],
  "wallsB" : [
    0,0,0,0,3,3,3,3,3,1,1,1,1,2,2,2,2,0,0,0,
    0,0,0,0,3,0,0,0,3,0,0,0,1,0,0,0,2,0,0,0,
    0,0,0,0,3,0,0,0,3,0,0,0,0,0,0,8,2,0,0,0,
    0,0,0,0,3,0,0,0,3,0,0,0,1,0,0,0,2,0,0,0,
    3,3,3,2,1,1,20,1,3,1,3,1,2,2,2,2,3,0,0,0,
    3,3,3,2,1,0,0,0,1,0,0,0,3,0,0,0,0,0,0,0,
    3,3,3,2,1,0,0,0,0,0,30,0,1,0,0,0,0,0,0,0,
    3,3,3,2,1,0,0,0,3,0,0,0,3,0,0,0,0,0,0,0,
    2,2,2,1,1,1,2,1,2,3,1,3,3,0,0,0,0,0,0,0,
    0,0,0,0,2,0,0,0,2,0,0,0,3,0,0,0,0,0,0,0,
    0,0,0,0,2,0,0,0,0,0,0,10,3,0,0,0,0,0,0,0,
    0,0,0,0,2,0,0,0,2,0,0,0,3,0,0,0,0,0,0,0,
    0,0,0,0,3,2,2,2,3,3,3,3,3,0,0,0,0,0,0,0,
    0,0,0,0,0,0,0,0,0,0,0,0,0,0,0,0,0,0,0,0,
    0,0,0,0,0,0,0,0,0,0,0,0,0,0,0,0,0,0,0,0,
    0,0,0,0,0,0,0,0,0,0,0,0,0,0,0,0,0,0,0,0,
    0,0,0,0,0,0,0,0,0,0,0,0,0,0,0,0,0,0,0,0,
    0,0,0,0,0,0,0,0,0,0,0,0,0,0,0,0,0,0,0,0,
    0,0,0,0,0,0,0,0,0,0,0,0,0,0,0,0,0,0,0,0,
    0,0,0,0,0,0,0,0,0,0,0,0,0,0,0,0,0,0,0,0

  ],
  "ColorsA" :[
    0.5,0,1,
    1,0,1,
    0,0,1
  ],
  "ColorsB" :[
    1,1,0,
    0.5,1,0,
    1,0.5,0
  ]

}