{
  "playerStart" : [6.5, 1.5],
  "wallsA" :[
    0,0,0,0,0,1,1,1,1,1,3,3,3,3,3,1,1,1,1,1,
    0,0,0,0,0,1,0,0,0,1,3,0,0,0,3,1,0,0,0,1,
    0,0,0,0,0,1,0,0,0,2,3,0,0,0,21,0,0,0,8,1,
    0,0,0,0,0,1,0,0,0,1,3,0,0,0,3,1,0,0,0,1,
    0,0,0,0,0,1,1,0,1,1,3,3,3,3,3,1,1,1,1,1,
    2,2,2,2,2,3,3,0,3,3,0,0,0,0,0,0,0,0,0,0,
    2,0,0,0,2,3,0,0,0,3,0,0,0,0,0,0,0,0,0,0,
    2,9,0,0,20,0,0,0,0,3,0,0,0,0,0,0,0,0,0,0,
    2,0,0,0,2,3,0,0,0,3,0,0,0,0,0,0,0,0,0,0,
    2,2,0,2,2,3,3,0,3,3,0,0,0,0,0,0,0,0,0,0,
    1,1,0,1,1,2,2,0,2,2,1,1,1,1,1,0,0,0,0,0,
    1,0,0,0,1,2,0,0,0,2,1,0,0,0,1,0,0,0,0,0,
    1,0,0,0,1,2,0,0,0,3,3,0,0,11,1,0,0,0,0,0,
    1,0,0,0,1,2,0,0,0,2,1,0,0,0,1,0,0,0,0,0,
    1,1,3,1,1,2,2,2,2,2,1,1,1,1,1,0,0,0,0,0,
    2,2,2,2,2,0,0,0,0,0,0,0,0,0,0,0,0,0,0,0,
    2,2,2,2,2,0,0,0,0,0,0,0,0,0,0,0,0,0,0,0,
    2,2,2,2,2,0,0,0,0,0,0,0,0,0,0,0,0,0,0,0,
    2,2,2,2,2,0,0,0,0,0,0,0,0,0,0,0,0,0,0,0,
    2,2,2,2,2,0,0,0,0,0,0,0,0,0,0,0,0,0,0,0
    ],
  "wallsB" : [
    0,0,0,0,0,1,1,1,1,1,3,3,3,3,3,1,1,1,1,1,
    0,0,0,0,0,1,0,0,0,1,3,0,0,0,3,1,1,1,1,1,
    0,0,0,0,0,1,0,0,0,0,0,0,0,0,2,1,1,1,1,1,
    0,0,0,0,0,1,0,0,0,1,3,0,0,0,3,1,1,1,1,1,
    0,0,0,0,0,1,1,2,1,1,3,3,3,3,3,1,1,1,1,1,
    2,2,2,2,2,3,3,3,3,3,0,0,0,0,0,0,0,0,0,0,
    2,2,2,2,2,3,3,3,3,3,0,0,0,0,0,0,0,0,0,0,
    2,2,2,2,2,3,3,3,3,3,0,0,0,0,0,0,0,0,0,0,
    2,2,2,2,2,3,3,3,3,3,0,0,0,0,0,0,0,0,0,0,
    2,2,2,2,2,3,3,3,3,3,0,0,0,0,0,0,0,0,0,0,
    1,1,3,1,1,2,2,3,2,2,1,1,1,1,1,0,0,0,0,0,
    1,0,0,0,1,2,0,0,0,2,1,0,0,0,1,0,0,0,0,0,
    1,0,0,0,1,2,0,0,0,0,0,0,0,0,1,0,0,0,0,0,
    1,0,0,0,1,2,0,0,0,2,1,0,0,0,1,0,0,0,0,0,
    1,1,0,1,1,2,2,2,2,2,1,1,1,1,1,0,0,0,0,0,
    2,2,0,2,2,0,0,0,0,0,0,0,0,0,0,0,0,0,0,0,
    2,0,0,0,2,0,0,0,0,0,0,0,0,0,0,0,0,0,0,0,
    2,0,0,0,2,0,0,0,0,0,0,0,0,0,0,0,0,0,0,0,
    2,0,10,0,2,0,0,0,0,0,0,0,0,0,0,0,0,0,0,0,
    2,2,2,2,2,0,0,0,0,0,0,0,0,0,0,0,0,0,0,0

  ],
  "ColorsA" :[
    1,0.5,0,
    1,1,0,
    1,0,0
  ],
  "ColorsB" :[
    0,1,0.5,
    0,1,0,
    0,1,1
  ]

}