{
  "playerStart" : [6.5, 1.5],
  "wallsA" :[
    3,3,3,3,3,1,1,1,1,1,3,3,3,3,3,1,1,1,1,1,
    3,3,3,3,3,1,0,9,0,1,3,3,3,3,3,1,1,1,1,1,
    3,3,3,3,3,1,0,0,0,1,3,3,3,3,3,1,1,1,1,1,
    3,3,3,3,3,1,0,0,0,1,3,3,3,3,3,1,1,1,1,1,
    3,3,3,3,3,1,1,0,1,1,3,3,3,3,3,1,1,1,1,1,
    2,2,2,2,2,3,3,0,3,3,2,2,2,2,2,3,3,3,3,3,
    2,2,2,2,2,3,0,0,0,3,2,0,0,0,2,3,3,3,3,3,
    2,2,2,2,2,2,0,0,0,40,0,0,0,0,2,3,3,3,3,3,
    2,2,2,2,2,3,0,0,0,3,2,0,0,0,2,3,3,3,3,3,
    2,2,2,2,2,3,3,40,3,3,2,2,2,2,2,3,3,3,3,3,
    1,1,1,1,1,2,2,0,2,2,1,1,1,1,1,2,2,2,2,2,
    1,1,1,1,1,2,0,0,0,2,1,1,1,1,1,2,2,2,2,2,
    1,1,1,1,1,2,0,0,0,2,1,1,1,1,1,2,2,2,2,2,
    1,1,1,1,1,2,0,10,0,2,1,1,1,1,1,2,2,2,2,2,
    1,1,1,1,1,2,2,2,2,2,1,1,1,1,1,2,2,2,2,2,
    2,2,2,2,2,3,3,3,3,3,2,2,2,2,2,3,3,3,3,3,
    2,2,2,2,2,3,3,3,3,3,2,2,2,2,2,3,3,3,3,3,
    2,2,2,2,2,3,3,3,3,3,2,2,2,2,2,3,3,3,3,3,
    2,2,2,2,2,3,3,3,3,3,2,2,2,2,2,3,3,3,3,3,
    2,2,2,2,2,3,3,3,3,3,2,2,2,2,2,3,3,3,3,3
    ],
  "wallsB" : [
    3,3,3,3,3,1,1,1,1,1,3,3,3,3,3,1,1,1,1,1,
    3,3,3,3,3,1,1,1,1,1,3,3,3,3,3,1,1,1,1,1,
    3,3,3,3,3,1,1,1,1,1,3,3,3,3,3,1,1,1,1,1,
    3,3,3,3,3,1,1,1,1,1,3,3,3,3,3,1,1,1,1,1,
    3,3,3,3,3,1,1,1,1,1,3,3,3,3,3,1,1,1,1,1,
    2,2,2,2,2,3,3,3,3,3,2,2,2,2,2,3,3,3,3,3,
    2,0,0,0,2,3,0,0,0,3,2,0,0,0,2,3,3,3,3,3,
    2,8,0,0,0,20,0,0,0,0,50,84,30,0,2,3,3,3,3,3,
    2,0,0,0,2,3,0,0,0,3,2,0,0,0,2,3,3,3,3,3,
    2,2,2,2,2,3,3,1,3,3,2,2,2,2,2,3,3,3,3,3,
    1,1,1,1,1,2,2,2,2,2,1,1,1,1,1,2,2,2,2,2,
    1,1,1,1,1,2,2,2,2,2,1,1,1,1,1,2,2,2,2,2,
    1,1,1,1,1,2,2,2,2,2,1,1,1,1,1,2,2,2,2,2,
    1,1,1,1,1,2,2,2,2,2,1,1,1,1,1,2,2,2,2,2,
    1,1,1,1,1,2,2,2,2,2,1,1,1,1,1,2,2,2,2,2,
    2,2,2,2,2,3,3,3,3,3,2,2,2,2,2,3,3,3,3,3,
    2,2,2,2,2,3,3,3,3,3,2,2,2,2,2,3,3,3,3,3,
    2,2,2,2,2,3,3,3,3,3,2,2,2,2,2,3,3,3,3,3,
    2,2,2,2,2,3,3,3,3,3,2,2,2,2,2,3,3,3,3,3,
    2,2,2,2,2,3,3,3,3,3,2,2,2,2,2,3,3,3,3,3

  ],
  "ColorsA" :[
    0.5,0,1,
    0,0,1,
    1,0,1
  ],
  "ColorsB" :[
    1,0.5,0,
    1,1,0,
    1,0,0
  ]

}